########
# p    #
# .   .#
#  oo  #
#      #
########
