#########
#       #
# ##o## #
# p   o #
##o...# #
##    # #
####  ###
#########
