 ###########
 #  #  # p #
 #  .o #   #
 #  #. # o##
##o # .#  # 
#   # o.  # 
#   #  #  # 
########### 