#####
#. .#
# op#
#ooo#
# o #
#...#
#####
